################
#"T....BTB...""#
#".....B.B...T"#
#"..BBBBBBBB.."#
#""..........""#
~#B####BB####B#~
~#B#~~#BB#~~#B#~
~#B####BB####B#~
#""..........""#
#"............"#
#....""""""....#
#....""""""....#
#BBBB..........#
#BBBB........."#
#XBBB..P.....""#
################