################
#""".........""#
#""".........."#
#""".........."#
#""".........""#
#######BB#######
#~~~~~#BB#~~~~~#
#######BB#######
#""..........""#
#"............"#
#....""""""....#
#....""""""....#
#....BBBBB.....#
#"...BBBBB...."#
#""..BBXBB...""#
################