################
#""..........""#
#".....R......"#
#"............"#
#""..........""#
#######..#######
#~~~~~#..#~~~~~#
#######..#######
#""..........""#
#"............"#
#....."""""....#
#....."""""....#
#..............#
#"....BBB....."#
#""...B.B....""#
################