################
#""....B.B...""#
#"T....B.B...."#
#"..BBBBBBBB.."#
#""..........""#
#######BB#######
#~~~~~#BB#~~~~~#
#######BB#######
#""..........""#
#"............"#
#....""""""....#
#....""""""....#
#BBBB..........#
#BBBB........."#
#XBBB..P.....""#
################