################
#""".........""#
#""".........."#
#""".........."#
#""".........""#
#######.########
#~~~~~#..#~~~~~#
#######..#######
#""..........""#
#"............"#
#....."""""....#
#....."""""....#
#..............#
#"............"#
#""....X.....""#
################