######################
#....................#
#....................#
#....................#
#....................#
#....................#
#....................#
#....................#
#....................#
#....................#
#....................#
#....................#
#....................#
#....................#
#....................#
#....................#
#....................#
#....................#
#....................#
#....................#
#....................#
#....................#
#....................#
#.....BBB............#
#.....BXB............#
#.....BBB............#
######################