################
#T.....#....T#~#
#............###
##BB#######B####
#............#~#
#..........#."##
#BBBBBBBBBB#...#
#..........#...#
#######."".#...#
#..........#...#
#..""".........#
#........"""...#
#BBBB...."""...#
#BBBB...."""."##
#XBBB..P.....#~#
################
#~~~~~~~~~~~~~~#
################